1111111111111111
1P000000000000C1
1011110111111001
1000010100000001
1111010101111001
1C00001000000001
1011111110111001
1000000000100E01
1111111111111111