111111111111111111
1P00000010000000C1
101111110111111101
100000000000000001
101011111111110101
1C0010000000100001
111001011111000111
1000000100000100E1
111111111111111111