1111111111111111111111
1P000000000000000000C1
1011111111111111111001
1000000000000000000001
1011110111111110111001
1000010100000000100001
1111010101111110101101
1C0000100000000100E001
1111111111111111111111