11111111111111111111111111111111
1P0000000000000000000C0000000001
10111111111111111111010000000001
10000000000000000000000000000001
10111111111111111111010000000001
10000000000000000000000000000001
10111111111111111111010000000001
1C0000000000000000000E0000000001
11111111111111111111111111111111